R       1200 800

NO ./Textures/Stone1.xpm
SO   ./Textures/Stone2.xpm
WE       ./Textures/Stone3.xpm
EA  ./Textures/Stone4.xpm
S ./Textures/pillar.xpm

F 100, 200 ,0
C 0  ,0,    100


111111111
100022001           11111111
10200E0011111111111112222001
1000000002000000020010222001
1100000011111111111111111021
1000000000000200002111110011
1002000002200000200011111201        1111
1111100111111000000211111001111111111221
1100220011111102220001111000022200000221
1102200111111111000000000000022200000001
1111111111111111000001111000022200000001
1111111111111111111111111111111111111111