R          1200 600

NO ./Textures/North.xpm


SO   ./Textures/wall_1.xpm
WE                ./Textures/wall_2.xpm
EA ./Textures/wall_3.xpm
S ./Textures/pillar.xpm


F 100, 0 ,0
C 225,30,0

11
11 11111111111
11100000000000111111111111111111111111111111111111111111111111111111111111111111111111111
  10010W000000000100000000000000000000000000000000000000000000000000000000000000000000001
  120010001001111111111111111111111111111111111111111111111111111111111111111111111111111
  1111111000000000000001
     1111111011111100001
111111111111011111101001
100000000000011111100001
10002220000000011111111111
100000101000111
11111111111111
     1