R          1200 600

NO ./Textures/North.xpm


SO   ./Textures/wall_1.xpm
WE                ./Textures/wall_2.xpm
EA ./Textures/wall_3.xpm
S ./Textures/pillar.xpm


F 100, 0 ,0
C 225,30,0

11
11 1111111111
11100000020001
  10010N000001
  120010111001
  111111100001
     111111101
11111111111101
10000002200001
10000002200001
10202010100011
11111111111111
     1