R    1200 600

NO ./Textures/North.xpm
SO   ./Textures/wall_1.xpm
WE   ./Textures/wall_2.xpm
EA ./Textures/wall_3.xpm
S ./Textures/pillar.xpm

F 100, 200, 0
C 0, 0, 100


111111111
100000001
102010001111111111111
1000N0000222200002001
110110101111111111111
1000000011111
1002000000001
1111111111111