R   20000 8000

NO ./Textures/wall_4.xpm
SO ./Textures/wall_1.xpm
WE   ./Textures/wall_2.xpm
EA ./Textures/wall_3.xpm
S ./Textures/sprite_3.xpm

F 100, 0 ,               0
C 220, 100,0

111111111
100022001           11111111
1020000011111111111112222001
10000N0000000000020010222001
1100000011111111111111111021
1000000000000200002111110011
1002000002200000200011111201        1111
1111100111111000000211111001111111111221
1100220011111102220001111000022200000221
1102200111111111000000000000022200000001
1111111111111111000001111000022200000001
1111111111111111111111111111111111111111